1111111111111111111111
10000P0000000000000011
1E00000000000000000001
1000000000C00000000001
1000C000000000C0000001
1C00000000000000000001
1111111111111111111111