1111111111111111111111
1000001P1000C00C000001
1110001000000000000001
111110C000000000111111
10000CCCCC000000100001
100000000000C00000E001
1111111111111111111111