11111111111111111
10101000000000C01
1C0C00CP100001011
1010C10100100E001
11111111111111111
